############################
#..............#..........#
#..####.#.###.#.#.###.#...#
#..#....#.#.#.#.#.#...#...#
#..#....#.#.#.#.#.#.#.#...#
#..####.#.#.#.#.#.#.#.#...#
#...........P............# #
#..###########....####....#
#....#.....#....###.#.....#
####.#.#.#.#.#.#.#.#.#....#
#....#.#.#.#.#.#.#.#.#....#
#..####.#.#.#.#.#.#.#.#...#
#.............#..........# #
############################
